{
  "1": "1",
  "2": "2",
  "3": "3",
  "4": "4",
  "5": "5",
  "6": "6",
  "7": "7",
  "8": "8",
  "9": "9",
  "0": "0",
  "-": "-",
  "=": "=",
  "q": "ქ",
  "w": "წ",
  "e": "ე",
  "r": "რ",
  "t": "ტ",
  "y": "ყ",
  "u": "უ",
  "i": "ი",
  "o": "ო",
  "p": "პ",
  "[": "[",
  "]": "]",
  "\\": "\\",
  "a": "ა",
  "s": "ს",
  "d": "დ",
  "f": "ფ",
  "g": "გ",
  "h": "ჰ",
  "j": "ჯ",
  "k": "კ",
  "l": "ლ",
  ";": ";",
  "'": "'",
  "z": "ზ",
  "x": "ხ",
  "c": "ც",
  "v": "ვ",
  "b": "ბ",
  "n": "ნ",
  "m": "მ",
  ",": ",",
  ".": ".",
  "/": "/",
  "!": "!",
  "@": "@",
  "#": "#",
  "$": "$",
  "%": "%",
  "^": "^",
  "&": "&",
  "*": "*",
  "(": "(",
  ")": ")",
  "_": "_",
  "+": "+",
  "Q": "",
  "W": "ჭ",
  "E": "",
  "R": "ღ",
  "T": "თ",
  "Y": "",
  "U": "",
  "I": "",
  "O": "`",
  "P": "~",
  "{": "{",
  "}": "}",
  "|": "|",
  "A": "",
  "S": "შ",
  "D": "",
  "F": "",
  "G": "",
  "H": "",
  "J": "ჟ",
  "K": "",
  "L": "",
  ":": ":",
  "\"": "\"",
  "Z": "ძ",
  "X": "",
  "C": "ჩ",
  "V": "",
  "B": "",
  "N": "",
  "M": "",
  "<": "<",
  ">": ">",
  "?": "?"
}
